###########
#o       o#
#         #
#         #
#o       o#
###########
