###############
#o           o#
# H H H H H H #
#             #
# H H H H H H #
#             #
# H H H H H H #
#             #
# H H H H H H #
#             #
# H H H H H H #
#             #
# H H H H H H #
#o           o#
###############